111111111
10P0C1E11
111111111

while (map[i])
map[i]=C(width)
i++;