1111111111111111111111111111111
1E000000000000000000000P0000001
1110010100100000101001000000011
1010010011101010001001000000011
100000000C00C000000000000000001
1C0000000000000C000000000C00001
1110010100100000101001000000011
101001001110101000100100C000011
100000000C00C000C00000000000001
1C0000000000000C00000C000C00001
1110010100100000101001000000011
1010010011101010001001000000011
1C0000000C00C000C00000C00000001
1111111111111111111111111111111
