11111111111111111
1C1A0C0000C010001
10100001001010011
1C000C0001C011E11
10100A0100100A011
1P101101000000011
11111111111111111



