111111111
100000C01
10P000001
10C000E01
100C00C01
111111111